11111111111
10C0P0E0001
11111111111