11111111111
10C0P0E0001
10C00C00C01
10001001001
10000C000E1
11111111111